F 253   ,100  ,  0    
C 225, 30, 0

NO ./textures/north.png
R 900 900

EA ./textures/east.png      
WE ./textures/west.png      
S ./textures/east.png   


SO ./textures/south.png


11111111
10000001
1000N111
111111111
