11111111111111




10000000000001
10000000100001
10000000000001
10000110000001
10000000000001
10000000000001
1000000N000001
10000000000001
11111111111111