F 220   ,100  ,  0    
C 225, 30, 0

NO ./textures/eagle.png
R 4000 4000

EA ./textures/redbrick.png      
WE ./textures/wood.png      
S ./textures/pillar.png   


SO ./textures/bluestone.png


11111111111111
10000000000001
10000000000001
10000000000001
100000000000N1
111111111111111
