F 0,0, 0
C 200, 1, 1

NO ./textures/eagle.png
SO ./textures/bluestone.png
R 1920 1080

EA ./textures/redbrick.png
WE ./textures/wood.png
S ./textures/barrel.png

111111111111111111111111     
100000000000000000000001     
100000000000000000000001
100000000000000000000001
10000000000W000000000001
100000000000000000000001
100000000000000000002001
100000000000000000000001
100000000000000000000001
100000000000000000000001
100000000000000000000001
111111111111111111111111
