F 220,100,0
C 225, 30, 0

NO ./textures/eagle.png
R 1920 1080



EA ./textures/redbrick.png
WE ./textures/wood.png
S ./textures/grind.png




SO ./textures/bluestone.png
 
 
    111111111       11111       11111    111111111111111                           1111111111111
  1110000000111     10001       10001    10001111111111111     111111111111111     10000000000011
11100000000000111   10001       10001    10001       110001   11000000000000011    100011111110011
10000111111100011   10001       10001    10001        10001    1111111111110001    10001     110011
100011     111111   10001       10001    10001        10001               11001    10001      110011
10001               10001       10001    10001        10001                1001    10001       110011
10001               10001       10001    10001       110011                1001    10001        11011
10001               10001       10001    10001111111110011         111111111001    10001         1011
10001               10001       10001    1000000000000001         1100000000001    10001         1011
10001               10001       10001    10001111111110011         111111111001    10001         1011
10001               10001       10001    10001        10011                1001    10001        11011
10001               10001       10001    10001        10001                1001    10001       110011
100011     111111111100011     110001111110001        10001               11001    10001      110011
1000011111110000000000000111111100000000000001        10001    1111111111110001111110001     110011
1110000000000011111111100000000000111111110001       110001   110000000000000000000000011111110011
  1010000000111       1110000000111      10001111111111111     1111111111111111111110000000000011
  10111111111           111111111        111111111111111                           1111111011111
  101                                                                                    101
11101       11111   11111       11111    11111                11111                      101
10S01       10001   10001111111110001    10001                10001                      101
10001       10001   10000000000000001    10001                10001                      101
10001       10001   10001111111110001    10001                10001                      101
10001       10001   11011       11011    10001                10001                      101
10001       10001    101                 10001                10001                      101
10001       10001    101  11111          10001                10001                      101
10001       10001    1011110001          10001                10001                      101
10001111111110001    1000000001          10001                10001                      101
10000000000000001    1011110001          10001                10001                      101
10001111111110001    101  11111          10001                10001                      101
10001       10001    101                 10001                10001                      101
10001       10001   11011       11011    10001                10001                      101
10001       10001   10001111111110001    10001       11111    10001       11111          101
10001       10001   10000000000000001    10001111111110001    10001111111110001          101
10001       10001   10001111111110001    10000000000000001    10000000000000001          101
11011       11111   11011       11111    11101111111111111    11101111111111111          101
 101                 101                   101                  101                      101
11011111111111111111110111111111111111111111011111111111111111111011111111111111111111111101
10000000000000000000000000000000000000000000000000000000000000000000000000000000000000000001
11111111111111111111111111111111111111111111111111111111111111111111111111111111111111111111