F 220,100,0
C 225, 30, 0

NO./textures/eagle.png
R 1920 1080



EA./textures/redbrick.png
WE./textures/wood.png
S./textures/grind.png

POEPEOEW


SO./textures/bluestone.png


111111111111111111111111     
100000000000000000000001     
100000000000000000000001
100000000000000000000001
100000000000000000000001
100000000000000000000001
100000000000000000000001
100000000000000000000001
100000000000000000000001
100000000000000000000001
100000000000000000000001
1000000000000W0000000001
100000000000000000000001
100000000000000000000001
100000000000000000000001
100000000000000000000001
100000000000000000000001
111111111000000000000001
110100001000000000000001
110000001000000000000001
110100001000000000000001
110111111000000000000001
110000000000000000000001
1000000000000000000000W1
111111111111111111111111